                            
############################
#                          #
# ## #### ######## #### ## #
# ##   ##    ##    ##   ## #
# #### ## ## ## ## ## #### #
# #### ## ## ## ## ## #### #
          ## ## ##          
# ## #### ##    ## #### ## #
# ## #### ######## #### ## #
# ## #### ######## #### ## #
# ##                    ## #
# #### ## ###  ### ## #### #
# #### ## #      # ## #### #
# ##   ## #      # ##   ## #
# ## #### ######## #### ## #
#                          #
#### ####### ## ####### ####
#### ####### ## ####### ####
        ##   ##   ##        
####### ## ###### ## #######
####### ## ###### ## #######
#    ## ##        ## ##    #
# ## ## ## ###### ## ## ## #
# ## ## ## ###### ## ## ## #
# ##         ##         ## #
# ##### #### ## #### ##### #
# ##### #### ## #### ##### #
#                          #
############################
                            